BBBBBBBBBBBBBBBBBBBBBBBBBBBBBBBBBBBBBBBBBBBBBBBBBBBBB
BBBBBBBBBBBBTBBBTTTBTBBBBBTBTTTBTBBBBBBTBBBBBBBBBBBBB
BBBBBBBBBBBBTBBBTBBBTBBBBBTBTBBBTBBBBBTTBBBBBBBBBBBBB
BBBBBBBBBBBBTBBBTTTBBTBBBTBBTTTBTBBBBTBTBBBBBBBBBBBBB
BBBBBBBBBBBBTBBBTBBBBBTBTBBBTBBBTBBBBBBTBBBBBBBBBBBBB
BBBBBBBBBBBBTTTBTTTBBBBTBBBBTTTBTTTBBBTTTBBBBBBBBBBBB
BBBBBBBBBBBBBBBBBBBBBBBBBBBBBBBBBBBBBBBBBBBBBBBBBBBBB
BBBBBBBBBBBBWWWWWWWWWWWWWWWWWWWWWWWWWWWWWBBBBBBBBBBBB
BBBBBBBBBBBBWWO------------------------WWBBBBBBBBBBBB
BBBBBBBBBBBBWW-WWWWWWWWWWWWWWWWWWWWWWW-WWBBBBBBBBBBBB
BBBBBBBBBBBBWW-WWWWWWWWWWWWWWWWWWWWWWW-WWBBBBBBBBBBBB
BBBBBBBBBBBBWW-WWWWWWWWWWWWWWWWWWWWWWW-WWBBBBBBBBBBBB
BBBBBBBBBBBBWW-WWWWWWWWWWWWWWWWWWWWWWW-WWBBBBBBBBBBBB
BBBBBBBBBBBBWW-WWWWWWWWWWWWWWWWWWWWWWW-WWBBBBBBBBBBBB
BBBBBBBBBBBBWW-WWWWWWWWWWWWWWWWWWWWWWW-WWBBBBBBBBBBBB
BBBBBBBBBBBBWW-WWWWWWWWWWWWWWWWWWWWWWW-WWBBBBBBBBBBBB
BBBBBBBBBBBBWW-WWWWWWWWWWWWWWWWWWWWWWW-WWBBBBBBBBBBBB
BBBBBBBBBBBBWW-WWWWWWWWWWWWWWWWWWWWWWW-WWBBBBBBBBBBBB
BBBBBBBBBBBBWW-WWWWWWWWWWWWWWWWWWWWWWW-WWBBBBBBBBBBBB
BBBBBBBBBBBBWW-WWWWWWWWWWWWWWWWWWWWWWW-WWBBBBBBBBBBBB
BBBBBBBBBBBBWW-WWWWWWWWWWWWWWWWWWWWWWW-WWBBBBBBBBBBBB
BBBBBBBBBBBBWW-WWWWWWWWWWWWWWWWWWWWWWW-WWBBBBBBBBBBBB
BBBBBBBBBBBBWW-WWWWWWWWWWWWWWWWWWWWWWW-WWBBBBBBBBBBBB
BBBBBBBBBBBBWW-------------------------WWBBBBBBBBBBBB
BBBBBBBBBBBBWWWWWWWWWWWWWWWWWWWWWWWWWWWWWBBBBBBBBBBBB
BBBBBBBBBBBBBBBBBBBBBBBBBBBBBBBBBBBBBBBBBBBBBBBBBBBBB
BBBBBBBBBBBBBBBBBBBBBBBBBBBBBBBBBBBBBBBBBBBBBBBBBBBBB