BBBBBBBBBBBBBBBBBBBBBBBBBBBBBBBBBBBBBBBBBBBBBBBBBBBBB
BBBBBBBBBBBBTBBBTTTBTBBBBBTBTTTBTBBBBTTTBBBBBBBBBBBBB
BBBBBBBBBBBBTBBBTBBBTBBBBBTBTBBBTBBBBBBTBBBBBBBBBBBBB
BBBBBBBBBBBBTBBBTTTBBTBBBTBBTTTBTBBBBTTTBBBBBBBBBBBBB
BBBBBBBBBBBBTBBBTBBBBBTBTBBBTBBBTBBBBTBBBBBBBBBBBBBBB
BBBBBBBBBBBBTTTBTTTBBBBTBBBBTTTBTTTBBTTTBBBBBBBBBBBBB
BBBBBBBBBBBBBBBBBBBBBBBBBBBBBBBBBBBBBBBBBBBBBBBBBBBBB
BBBBBBBBBBBBWWWWWWWWWWWWWWWWWWWWWWWWWWWWWBBBBBBBBBBBB
BBBBBBBBBBBBWWWWWWWWWWWWW--------------WWBBBBBBBBBBBB
BBBBBBBBBBBBWWWWWWWWWWWWW-WWWWWWWWWWWWWWWBBBBBBBBBBBB
BBBBBBBBBBBBWWWWWWWWWWWWW-WWWWWWWWWWWWWWWBBBBBBBBBBBB
BBBBBBBBBBBBWWWWWWWWWWWWW-WWWWWWWWWWWWWWWBBBBBBBBBBBB
BBBBBBBBBBBBWWWWWWWWWWWWW-WWWWWWWWWWWWWWWBBBBBBBBBBBB
BBBBBBBBBBBBWWWWWWWWWWWWW-WWWWWWWWWWWWWWWBBBBBBBBBBBB
BBBBBBBBBBBBWWWWWWWWWWWWW-WWWWWWWWWWWWWWWBBBBBBBBBBBB
BBBBBBBBBBBBWWWWWWWWWWWWW-WWWWWWWWWWWWWWWBBBBBBBBBBBB
BBBBBBBBBBBBWW-------------------------WWBBBBBBBBBBBB
BBBBBBBBBBBBWW-WWWWWWWWWW-WWWWWWWWWWWW-WWBBBBBBBBBBBB
BBBBBBBBBBBBWW-WWWWWWWWWW-WWWWWWWWWWWW-WWBBBBBBBBBBBB
BBBBBBBBBBBBWW-WWWWWWWWWW-WWWWWWWWWWWW-WWBBBBBBBBBBBB
BBBBBBBBBBBBWW-WWWWWWWWWW-WWWWWWWWWWWW-WWBBBBBBBBBBBB
BBBBBBBBBBBBWW-WWWWWWWWWW-WWWWWWWWWWWW-WWBBBBBBBBBBBB
BBBBBBBBBBBBWW-WWWWWWWWWW-WWWWWWWWWWWW-WWBBBBBBBBBBBB
BBBBBBBBBBBBWW-WWWWWWWWWW-WWWWWWWWWWWW-WWBBBBBBBBBBBB
BBBBBBBBBBBBWWOWWWWWWWWWW--------------WWBBBBBBBBBBBB
BBBBBBBBBBBBWWWWWWWWWWWWWWWWWWWWWWWWWWWWWBBBBBBBBBBBB
BBBBBBBBBBBBBBBBBBBBBBBBBBBBBBBBBBBBBBBBBBBBBBBBBBBBB
BBBBBBBBBBBBBBBBBBBBBBBBBBBBBBBBBBBBBBBBBBBBBBBBBBBBB