BBBBBBBBBBBBBBBBBBBBBBBBBBBBBBBBBBBBBBBBBBBBBBBBBBBBB
BBBBBBBBBBBBTBBBTTTBTBBBBBTBTTTBTBBBBTTTBBBBBBBBBBBBB
BBBBBBBBBBBBTBBBTBBBTBBBBBTBTBBBTBBBBBBTBBBBBBBBBBBBB
BBBBBBBBBBBBTBBBTTTBBTBBBTBBTTTBTBBBBTTTBBBBBBBBBBBBB
BBBBBBBBBBBBTBBBTBBBBBTBTBBBTBBBTBBBBBBTBBBBBBBBBBBBB
BBBBBBBBBBBBTTTBTTTBBBBTBBBBTTTBTTTBBTTTBBBBBBBBBBBBB
BBBBBBBBBBBBBBBBBBBBBBBBBBBBBBBBBBBBBBBBBBBBBBBBBBBBB
BBBBBBBBBBBBWWWWWWWWWWWWWWWWWWWWWWWWWWWWWBBBBBBBBBBBB
BBBBBBBBBBBBWWWWW-----------------------WBBBBBBBBBBBB
BBBBBBBBBBBBWWWWW-------------------WWW-WBBBBBBBBBBBB
BBBBBBBBBBBBWWWWWWWW-WWWWWWW-WWWWWW-WWW-WBBBBBBBBBBBB
BBBBBBBBBBBBWWWWWWWW-WWWWWWW-WWWWWW-WWW-WBBBBBBBBBBBB
BBBBBBBBBBBBWWWWWWWW-WWWWWWW-WWWWWW-WWWWWBBBBBBBBBBBB
BBBBBBBBBBBBW-------------WW------------WBBBBBBBBBBBB
BBBBBBBBBBBBW-WWWWWW-WWWW-WWWWWWWWW-WWW-WBBBBBBBBBBBB
BBBBBBBBBBBBW-WWWWWW--------------------WBBBBBBBBBBBB
BBBBBBBBBBBBW-WWWWWWWWWWWWWWWWWWWWWWWWWWWBBBBBBBBBBBB
BBBBBBBBBBBBW-WWWWWWWWWWWWWWWWWWWWWWWWWWWBBBBBBBBBBBB
BBBBBBBBBBBBW-WWWWWWWWWWWWWWWWWWWWWWWWWWWBBBBBBBBBBBB
BBBBBBBBBBBBW-WWWWWWWWWWWWWWWWWWWWWWWWWWWBBBBBBBBBBBB
BBBBBBBBBBBBW-WWW------------------WWWWWWBBBBBBBBBBBB
BBBBBBBBBBBBW--------------WWW--------WWWBBBBBBBBBBBB
BBBBBBBBBBBBWWWWWWWWWWWWWWWWWWWWWWWWW-WWWBBBBBBBBBBBB
BBBBBBBBBBBBWWWWWWWWWWWWWWWWWWWWWWWWW-WWWBBBBBBBBBBBB
BBBBBBBBBBBBWWWWWWWWWWWWWWWWWWWWWWWWWOWWWBBBBBBBBBBBB
BBBBBBBBBBBBWWWWWWWWWWWWWWWWWWWWWWWWWWWWWBBBBBBBBBBBB
BBBBBBBBBBBBBBBBBBBBBBBBBBBBBBBBBBBBBBBBBBBBBBBBBBBBB
BBBBBBBBBBBBBBBBBBBBBBBBBBBBBBBBBBBBBBBBBBBBBBBBBBBBB